%%%%%%%%%%%%%%%%%%%%%%%%%%%%%%%
%.....%........P........%.....%
%.%%%.%.%%%.%%%%%%%.%%%.%.....%
%.%...%.%......%......%.%.....%
%...%%%.%G%%%%.%.%%%%..G%%%...%
%%%.%.%.%.%......%..%.%...%.%%%
%...%.%%%.%.%%% %%%.%.%%%.%...%
%.%%%.......%     %.......%%%.%
%...%G%%%%%.%%%%%%%.%.%%%G%...%
%%%.%...%.%....%....%.%...%.%%%
%...%%%.%.%%%%.%.%%%%.%.%%%...%
%.......%......%......%.....%.%
%.....%.%%%.%%%%%%%.%%%.%.%%%.%
%.....%........P....%...%.....%
%%%%%%%%%%%%%%%%%%%%%%%%%%%%%%%
